{
0x00000000,
0x00000000,
0x00000000,
0x01F80000,
0x03FC0000,
0x07FE0000,
0x0FFF0000,
0x0FFF0000,
0x1FFF8000,
0x1FFF8000,
0x1FFF8000,
0x0FFF8000,
0x0FFF8000,
0x03FFC000,
0x07FEC000,
0x0FFF0000,
0x0FFF0000,
0x0FFF0000,
0x07FE0000,
0x03FC0000,
0x03FC0000,
0x039C0000,
0x00000000,
0x00000000,
0x00000000,
0x00000000,
0x00000000,
0x00000000,
0x00000000,
0x00000000,
0x00000000,
0x00000000
};