{
0x00000000,
0x00000000,
0x00000000,
0x00001F80,
0x00003FC0,
0x00007FE0,
0x0000FFF0,
0x0000FFF0,
0x0001FFF8,
0x0001FFF8,
0x0001FFF8,
0x0001FFF0,
0x0001FFF0,
0x0003FFC0,
0x00037FE0,
0x0000FFF0,
0x0000FFF0,
0x0000FFF0,
0x00007FE0,
0x00003FC0,
0x00003FC0,
0x000039C0,
0x00000000,
0x00000000,
0x00000000,
0x00000000,
0x00000000,
0x00000000,
0x00000000,
0x00000000,
0x00000000,
0x00000000
};