{
0x00000000,
0x00000000,
0x00000000,
0x00000000,
0x00000000,
0x00000000,
0x00000000,
0x00000000,
0x00010000,
0x00097C00,
0x00056000,
0x003BA000,
0x005FF000,
0x00BFE000,
0x00874000,
0x00892000,
0x00810000,
0x03E00000,
0x0FF80000,
0x1FFC0000,
0x3FFE0000,
0x3FFE0000,
0x7FFF0000,
0x7FFF0000,
0x7FFF0000,
0x7FFF0000,
0x7FFF0000,
0x3FFE0000,
0x3FFE0000,
0x1FFC0000,
0x0FF80000,
0x03E00000
};