{
0x00000000,
0x0F81F000,
0x1FC3F800,
0x3FE7FC00,
0x7FFFFE00,
0x7FFFFE00,
0x7FFFFE00,
0x7FFFFE00,
0x7FFFFE00,
0x7FFFFE00,
0x3FFFFC00,
0x3FFFFC00,
0x1FFFF800,
0x0FFFF000,
0x07FFE000,
0x03FFC000,
0x01FF8000,
0x00FF0000,
0x007E0000,
0x003C0000,
0x00180000,
0x00000000,
0x00000000,
0x00000000,
0x00000000,
0x00000000,
0x00000000,
0x00000000,
0x00000000,
0x00000000,
0x00000000,
0x00000000
};