{
0x00000000,
0x00000000,
0x00FFF000,
0x01FFF800,
0x03FFFC00,
0x07FFFE00,
0x0FFFFF00,
0x0FFFFF00,
0x0FFFFF00,
0x0FFFFF00,
0x0FFFFF00,
0x0FFFFF00,
0x07FFFE00,
0x03FFFC00,
0x01FFF800,
0x00FFF000,
0x007FE000,
0x003FC000,
0x001F8000,
0x00060000,
0x00000000,
0x00000000,
0x00000000,
0x00000000,
0x00000000,
0x00000000,
0x00000000,
0x00000000,
0x00000000,
0x00000000,
0x00000000,
0x00000000
};