{
0x00000000,
0x007FC000,
0x01FFF000,
0x03FFF800,
0x07FFFC00,
0x0FFFFE00,
0x0FFFFE00,
0x1FFFFF00,
0x1FFFFF00,
0x1FFFFF00,
0x1FFFFF00,
0x3FFFFF80,
0x3FFFFF80,
0x3FFFFF80,
0x3FFFFF80,
0x3FFFFF80,
0x3FFFFF80,
0x1FFFFF00,
0x1FFFFF00,
0x1FFFFF00,
0x1FFFFF00,
0x0FFFFE00,
0x0FFFFE00,
0x07FFFC00,
0x03FFF800,
0x01FFF000,
0x007FC000,
0x00000000,
0x00000000,
0x00000000,
0x01800000,
0x01FF3800
};