{
0x0001F000,
0x0003FC00,
0x0003FE00,
0x0007FF00,
0x0007FF80,
0x0007FF80,
0x000FFF80,
0x000FFF80,
0x000FFF80,
0x0007FF00,
0x0007FF80,
0x000FFFC0,
0x001FFFE0,
0x003FFFFC,
0x007FFFFE,
0x007FFFFF,
0x007FFFFF,
0x003FFFFF,
0x0007FF7F,
0x000FFF36,
0x001FFF80,
0x001FFFE0,
0x001F0FF0,
0x003F87F8,
0x007F83FC,
0x007F81FC,
0x003F00F8,
0x00000000,
0x00000000,
0x00000000,
0x00000000,
0x00000000
};