{
0x000F8000,
0x003FC000,
0x007FC000,
0x00FFE000,
0x01FFE000,
0x01FFE000,
0x01FFF000,
0x01FFF000,
0x01FFF000,
0x00FFE000,
0x01FFE000,
0x03FFF000,
0x07FFF800,
0x3FFFFC00,
0x7FFFFE00,
0xFFFFFE00,
0xFFFFFE00,
0xFFFFFC00,
0xFEFFE000,
0x6CFFF000,
0x01FFF800,
0x07FFF800,
0x0FF0F800,
0x1FE1FC00,
0x3FC1FE00,
0x3F81FE00,
0x1F00FC00,
0x00000000,
0x00000000,
0x00000000,
0x00000000,
0x00000000
};