{
0x00FFC000,
0x01FFE000,
0x03FFF000,
0x07FFF800,
0x0FFFFC00,
0x1FFFFE00,
0x3FFFFF00,
0x3FFFFF00,
0x3FFFFF00,
0x3FFFFF00,
0x3FFFFF00,
0x3FFFFF00,
0x3FFFFF00,
0x3FFFFF00,
0x3FFFFF00,
0x3FFFFF00,
0x1FFFFE00,
0x0FFFFC00,
0x07FFF800,
0x03FFF000,
0x01FFE000,
0x00FFD000,
0x00000000,
0x00000000,
0x00000000,
0x00000000,
0x00000000,
0x00000000,
0x00000000,
0x00000000,
0x00000000,
0x00000000
};